   NO    Bonus/assets/walls/wall0.png
SO Bonus/assets/walls/wall2.png
WE Bonus/assets/walls/wall3.png
EA Bonus/assets/walls/wall1.png

F    255, 255, 255      
C                3,33,3


111111111111111111111
1E0000000000000000001
111111111111111111111