NO Bonus/assets/walls/nazi.png
SO Bonus/assets/walls/wall2.png
WE Bonus/assets/walls/wall3.png
EA Bonus/assets/walls/wall1.png

C    100     ,                 100,   100     
F 33,33,33

111111111111111111111111111111111111111111111111111111111111111111111111111111111111111111111111111111
111111111111111111111111111111111111111111111111111111111111111111111111111111111111
100000000000000000000000000000000000000000000000000000000000000000000000000000000011
100000000000000000000000000000000000000000000000000000000000000000000000000000000011
10000000000000000001111111DD111111111000000000000000000000000000000000000000000000111
10000000000000000E0D0000000000000000D0000000000000000000000000000000000000000000000111
1000000000000000000111111111111D11111000000000000000000000000000000D0000000000000111
100000000000000000000000000000000000000000000000000000000000000000000000000000000011
100000000000000000000000000000000000000000000000000000000000000000000000000000000011
111111111111111111111111111111111111111111111111111111111111111111111111111111111111