   NO    Bonus/assets/walls/wall0.png
SO Bonus/assets/walls/wall2.png
WE Bonus/assets/walls/wall3.png
EA Bonus/assets/walls/wall1.png

C    100     ,                 100,   100       
F                3,33,3


11111111111111111111
1E000000000D00000001
11111111111111111111